50     //cabbage
6000   //condor score
600    //vegetable unit score
400    //ice unit score
800    //nitpicker unit score
30     //brick unit score
0,0,0,0,0,0,0,0,0,0,0,0,0,0,0,0,0,0,0,0,0,0,0,0,0,0,0,0,0,0,0,0
0,0,0,0,0,0,0,0,0,0,0,0,0,0,0,0,0,0,0,0,0,0,0,0,0,0,0,0,0,0,0,0
0,0,0,0,0,0,0,0,0,0,0,0,0,0,0,0,0,0,0,0,0,0,0,0,0,0,0,0,0,0,0,67
0,0,0,0,0,0,0,0,0,0,0,0,0,0,0,0,0,0,0,0,0,0,0,0,0,0,0,0,0,0,0,0
0,0,0,0,0,0,0,0,0,0,0,0,0,0,0,0,0,0,0,0,0,0,0,0,0,0,0,0,0,0,0,0
0,0,0,0,0,0,0,0,0,0,0,0,0,0,0,0,0,0,0,0,0,0,0,0,0,0,0,0,0,0,0,0
0,0,0,0,0,0,0,0,0,0,0,0,0,0,0,0,0,0,0,0,0,0,0,0,0,0,0,0,0,0,0,0
0,0,0,0,0,0,0,0,0,0,0,0,0,0,0,0,0,0,0,0,0,0,0,0,0,0,0,0,0,0,0,0
0,0,0,0,0,0,0,0,0,0,0,0,0,0,0,0,0,0,0,0,0,0,0,0,0,0,0,0,0,0,0,0
0,0,0,0,0,0,0,0,0,0,0,0,0,0,0,0,0,0,0,0,0,0,0,0,0,0,0,0,0,0,0,0
0,0,0,0,0,0,0,0,0,0,0,0,0,0,0,0,0,0,0,0,0,0,0,0,0,0,0,0,0,0,0,0
0,0,0,0,0,0,0,0,0,0,0,0,0,0,0,0,0,0,0,0,0,0,0,0,0,0,0,0,0,0,0,0
0,0,0,0,0,0,29,29,29,29,29,29,29,0,0,0,0,0,0,0,29,29,29,29,29,29,0,0,0,0,0,0
0,0,0,0,0,0,40,0,0,45,45,45,46,0,0,0,0,47,45,0,46,0,47,40,0,0,0,0,0,0,0,0
0,0,0,0,0,0,39,0,0,0,47,47,47,45,0,0,0,0,0,0,45,0,0,39,0,0,0,0,0,0,0,0
0,0,0,0,0,0,40,0,0,0,0,0,47,45,0,46,45,45,45,46,45,45,0,40,0,0,0,0,0,0,0,0
0,0,0,0,0,39,0,0,47,0,45,46,45,45,0,0,45,46,45,45,45,45,0,0,39,0,0,0,0,0,0,0
37,0,0,0,0,40,0,0,0,47,47,47,45,0,46,45,0,0,0,0,0,0,47,47,40,0,0,0,0,0,0,0
0,0,0,0,0,39,0,0,47,45,0,46,0,0,0,0,0,0,47,47,47,45,0,46,39,0,0,0,0,0,0,0
0,0,0,0,0,40,0,0,47,47,47,0,0,47,47,47,45,0,0,0,0,46,46,0,40,0,0,0,0,0,0,0
0,0,0,0,0,39,0,0,0,0,0,0,45,46,0,0,0,0,0,0,0,0,0,0,39,0,0,0,0,0,0,0
0,0,0,0,0,40,0,0,45,46,45,45,45,45,0,0,0,0,45,45,46,45,0,0,40,0,0,0,0,0,0,0
0,0,0,0,0,39,0,0,29,29,29,29,29,47,0,46,0,0,0,29,29,29,0,0,39,0,0,0,0,0,0,0
0,0,0,0,40,0,0,45,47,47,47,45,0,0,0,0,0,0,45,45,45,0,46,46,45,40,0,0,0,0,0,0
0,0,0,0,39,0,0,46,47,47,0,46,0,46,47,47,0,46,0,0,0,46,47,0,0,39,0,0,0,0,0,0
0,0,0,0,40,0,0,0,0,0,0,0,0,0,0,0,45,45,46,45,0,0,47,47,47,40,0,0,0,0,0,0
0,0,0,0,39,0,0,0,45,45,46,45,0,0,0,45,46,0,47,0,0,46,46,0,0,39,0,0,0,0,0,0
0,0,0,0,40,0,0,0,45,45,0,45,45,0,0,29,29,29,29,46,0,0,47,47,0,40,0,0,0,0,0,0
0,0,0,0,39,0,0,0,0,0,0,0,0,0,0,47,45,0,46,0,0,46,0,0,0,39,0,0,0,0,0,0
0,0,0,0,40,0,0,0,45,45,46,45,47,47,47,45,0,0,0,0,45,47,47,0,0,40,0,0,0,0,0,0
0,0,0,39,0,0,0,0,0,0,0,45,46,45,45,0,0,0,47,47,47,0,0,0,0,0,39,0,0,0,0,0
0,0,0,40,0,0,0,45,45,46,45,0,47,45,0,46,0,0,0,47,46,46,0,0,0,45,40,0,0,0,0,0
0,0,0,39,37,46,0,0,0,0,0,37,45,0,0,46,0,0,0,36,0,0,0,0,0,46,39,36,0,0,0,0
0,0,0,40,0,0,0,0,47,46,46,0,0,0,47,47,47,45,0,0,0,46,46,46,0,0,40,0,0,0,0,0
0,0,0,39,0,0,45,0,0,0,47,47,50,0,46,45,46,46,0,0,45,47,47,0,45,0,39,0,0,0,0,0
0,0,0,40,0,0,0,45,45,46,45,0,45,0,0,0,0,0,45,45,46,45,0,0,0,0,40,0,0,0,0,0
0,0,0,39,0,0,0,0,45,0,46,0,0,0,0,0,0,46,0,0,0,0,47,47,0,45,39,0,0,0,0,0
0,0,40,36,0,0,0,0,0,37,0,0,47,45,0,46,0,0,0,0,0,0,47,45,0,37,0,40,0,0,0,0
0,0,39,0,0,46,0,47,47,47,45,0,0,45,0,0,0,47,47,0,0,0,45,46,45,45,0,39,0,0,0,0
0,0,40,0,0,45,0,45,45,0,0,0,0,0,0,0,45,45,46,45,0,0,45,45,0,0,0,40,0,0,0,0
0,0,39,0,0,0,0,0,47,47,0,46,46,0,0,47,46,46,0,47,50,0,46,46,0,0,0,39,0,0,0,0
0,0,40,0,0,47,46,46,0,0,0,45,0,45,46,45,45,46,45,45,47,0,45,46,45,45,0,40,0,0,0,0
0,0,39,0,0,0,0,0,0,0,0,37,0,0,0,0,0,0,0,0,0,47,0,0,0,0,0,39,0,0,0,37
0,0,40,0,0,0,46,47,47,0,46,0,0,0,0,0,45,0,0,0,47,47,0,0,0,0,0,40,0,0,0,0
0,39,0,0,0,0,0,0,47,47,0,46,46,0,0,0,0,47,47,47,45,0,0,45,46,45,45,0,39,0,0,0
0,40,0,0,0,0,0,0,0,0,44,0,0,0,0,47,46,46,0,0,0,45,45,46,45,0,0,0,40,0,0,0
0,39,0,0,0,0,0,0,0,47,47,0,46,0,0,0,0,45,46,45,45,46,45,45,0,0,46,0,39,0,0,0
37,40,0,0,0,47,47,47,45,0,0,0,0,0,0,36,47,47,0,46,0,0,0,45,45,46,45,0,40,0,0,0
0,39,0,0,0,0,0,0,0,0,0,0,0,0,47,47,0,46,46,0,45,0,0,0,47,47,0,0,39,0,0,0
0,40,0,0,46,47,47,0,46,0,0,0,47,47,0,46,46,0,0,45,45,46,45,0,0,0,0,0,40,0,0,0
0,39,0,0,0,0,0,47,46,46,0,0,45,45,46,45,0,0,47,47,47,45,0,0,0,0,0,0,39,0,0,0
40,0,0,0,0,0,0,0,0,0,0,0,47,47,0,46,0,0,0,0,0,47,46,46,50,0,0,0,0,40,0,0
39,0,0,0,47,46,46,0,0,0,0,0,45,0,0,0,47,47,0,47,47,0,46,0,0,0,0,0,0,39,0,0
40,0,0,0,0,0,29,29,29,29,0,0,0,29,29,29,29,29,29,0,0,0,29,29,29,29,0,0,0,40,0,0
39,0,0,0,0,47,0,46,45,0,0,0,47,47,47,45,0,0,0,0,0,0,0,0,0,0,0,0,0,39,0,0
40,0,0,45,46,0,47,46,47,47,0,46,45,45,46,45,45,46,0,47,0,0,47,46,46,0,45,45,0,40,0,0
39,0,0,0,45,0,46,45,0,47,47,47,45,0,46,0,0,46,45,45,0,45,47,47,0,46,46,0,47,39,0,0
29,29,29,29,29,29,29,45,46,29,29,29,29,29,29,0,46,29,29,29,29,29,29,0,0,29,29,29,29,29,29,29
17,0,0,0,0,0,0,0,0,0,0,0,0,0,0,0,0,0,0,0,0,0,0,0,0,0,18,0,0,0,0,0
0,0,0,0,0,0,0,0,0,0,0,0,0,0,0,0,0,0,0,0,0,0,0,0,0,0,0,0,0,0,0,0
0,0,0,65,0,0,0,0,0,0,0,0,0,0,0,0,0,0,0,0,0,0,0,0,0,0,0,0,65,0,0,0
0,0,0,0,0,0,0,0,0,0,0,0,0,0,0,0,0,0,0,0,0,0,0,0,0,0,0,0,0,0,0,0
0,0,0,0,0,0,0,0,0,0,0,0,0,0,0,0,0,0,0,0,0,0,0,0,0,0,0,0,0,0,0,0
29,29,29,29,29,29,4,4,0,0,4,4,0,0,4,4,0,0,4,4,0,0,4,4,0,0,29,29,29,29,29,29
19,0,0,0,0,0,4,7,0,0,0,7,0,0,7,0,0,0,4,4,0,0,4,7,0,0,20,0,0,0,0,0
0,0,0,0,0,0,0,0,0,0,0,0,0,0,0,0,0,0,0,0,0,0,0,0,0,0,0,0,0,0,0,0
0,0,0,64,0,0,0,0,0,0,0,0,0,0,0,0,0,0,0,0,0,0,0,0,0,0,0,0,64,0,0,0
0,0,0,0,0,0,0,0,0,0,0,0,0,0,0,0,0,0,0,0,0,0,0,0,0,0,0,0,0,0,0,0
0,0,0,0,0,0,0,0,0,0,0,0,0,0,0,0,0,0,0,0,0,0,0,0,0,0,0,0,0,0,0,0
29,29,29,29,29,29,0,0,0,37,0,0,0,0,0,0,0,0,0,0,0,0,0,0,0,0,29,29,29,29,29,29
17,0,0,0,0,0,0,0,0,0,0,0,0,0,0,0,0,0,0,0,0,0,0,0,0,0,18,0,0,0,0,0
0,0,0,0,0,0,0,0,0,0,0,0,0,0,0,0,0,0,0,0,0,0,0,0,0,0,0,0,0,0,0,0
0,0,0,63,0,0,0,0,0,0,0,0,0,0,0,0,0,0,0,0,0,0,0,0,0,0,0,0,63,0,0,0
0,0,0,0,0,0,0,0,0,0,0,0,0,0,0,0,0,0,0,0,0,0,0,0,0,0,0,0,0,0,41,0
0,0,0,0,0,0,0,0,0,0,0,0,0,0,0,0,0,0,0,0,0,0,0,0,0,0,0,0,0,0,0,0
29,29,29,29,29,29,4,4,4,4,4,4,4,4,4,4,4,4,4,4,4,4,29,4,4,4,29,29,29,29,29,29
15,0,0,0,0,0,4,4,4,4,4,4,4,4,7,0,0,7,4,4,4,4,29,4,4,7,0,16,0,0,0,0
0,0,0,0,0,0,0,0,0,0,0,0,0,0,0,0,0,0,0,0,0,0,29,0,0,0,0,0,0,0,0,0
0,0,62,0,0,0,0,0,0,0,0,0,0,0,0,0,0,0,0,0,0,0,28,0,0,0,0,0,0,62,0,0
0,41,0,0,0,0,0,0,0,0,0,0,0,0,0,0,0,0,0,0,0,0,28,0,0,0,0,0,0,0,0,0
0,0,0,0,0,0,0,0,0,0,0,0,0,0,0,0,0,0,0,0,0,0,28,0,0,0,0,0,0,0,0,0
28,28,28,28,28,3,3,3,3,28,3,3,3,3,3,0,0,3,3,3,3,28,28,28,3,3,3,28,28,28,28,28
15,0,0,0,0,6,0,6,3,28,3,3,3,3,6,0,0,6,3,3,3,3,6,0,6,3,3,16,0,0,0,0
0,0,0,0,0,0,0,0,0,28,0,0,0,0,0,0,0,0,0,0,0,0,0,0,0,0,0,0,0,0,0,66
0,0,61,0,0,0,0,0,0,28,0,0,0,0,0,0,0,0,0,0,0,0,0,0,0,0,0,0,0,61,0,0
0,0,0,0,0,0,0,0,0,28,0,0,0,0,0,0,0,0,0,0,0,0,0,0,0,0,0,0,0,0,0,0
0,0,0,0,0,0,0,0,0,28,0,0,0,0,0,0,0,0,0,0,0,0,0,0,0,0,0,0,0,0,0,0
28,28,28,28,28,24,24,24,35,35,35,24,24,24,24,24,24,24,24,24,24,24,24,24,24,24,24,28,28,28,28,28
15,0,0,0,0,3,3,3,3,6,0,0,0,6,3,3,3,6,0,0,0,6,3,3,3,3,3,16,0,0,0,0
0,0,0,0,0,0,0,0,0,0,0,0,0,0,0,0,0,0,0,0,0,0,0,0,0,0,0,0,0,0,0,0
0,0,60,0,0,0,0,0,0,0,0,0,0,0,0,0,0,0,0,0,0,0,0,0,0,0,0,0,0,60,0,0
0,0,0,0,0,0,0,0,0,0,0,0,0,0,0,0,0,0,0,0,0,0,0,0,0,0,0,0,0,0,41,0
0,0,0,0,0,0,0,0,0,0,0,0,0,0,0,0,0,0,0,0,0,0,0,0,0,0,0,0,0,0,0,0
28,28,28,28,28,3,3,3,3,3,3,3,3,3,3,3,3,3,3,3,3,3,3,3,3,3,3,28,28,28,28,28
11,0,0,0,0,6,3,3,3,6,0,0,0,0,0,6,3,3,3,3,3,6,0,6,3,3,3,0,12,0,0,0
0,0,0,0,0,0,0,0,0,0,0,0,0,0,0,0,0,0,0,0,0,0,0,0,0,0,0,0,0,0,0,0
0,59,0,0,0,0,0,0,0,0,0,0,0,0,0,0,0,0,0,0,0,0,0,0,0,0,0,0,0,0,59,0
0,0,0,0,0,0,0,0,0,0,0,0,0,0,0,0,0,0,0,0,0,0,0,0,0,0,0,0,0,0,0,0
0,0,0,0,0,0,0,0,0,0,0,0,0,0,0,0,0,0,0,0,0,0,0,0,0,0,0,0,0,0,0,0
27,27,27,27,37,0,0,0,0,0,0,0,0,0,0,0,0,0,0,0,0,0,0,0,0,0,0,0,27,27,27,27
9,0,0,0,0,0,0,0,0,0,0,0,0,0,0,0,0,0,0,0,0,0,0,0,0,0,0,0,10,0,0,0
0,0,0,0,0,0,0,0,0,0,0,0,0,0,0,0,0,0,0,0,0,0,0,0,0,0,0,0,0,0,0,0
0,58,0,0,0,0,0,0,0,0,0,0,0,0,0,0,0,0,0,0,0,0,0,0,0,0,0,0,0,0,58,0
0,41,0,0,0,0,0,0,1,0,0,0,0,0,0,0,0,0,0,0,0,0,0,0,0,0,0,0,0,0,0,0
0,0,0,0,0,0,0,0,0,0,0,0,0,0,0,0,0,0,0,0,0,0,0,0,0,0,0,0,0,0,0,0
27,27,27,27,2,2,2,2,2,2,2,2,2,2,2,2,2,2,2,2,2,2,2,2,2,2,2,2,27,27,27,27
43,43,43,43,43,43,43,43,43,43,43,43,43,43,43,43,43,43,43,43,43,43,43,43,43,43,43,43,43,43,43,43